add-in	дада́так -а
addin	дада́так -а
add-on	дада́так -а
addon	дада́так -а
adjust	настаўля́ць, наста́віць	настаўляецца ўсё, што не рэґулюецца
adjust	рэґулява́ць, адрэґулява́ць	рэґулюецца тое, што зьмяняецца рэґулятарам
alarm	аля́рм -у
alarm	алярмава́ць
alert	апавяшчэ́ньне
alert	перасьцяро́га
align left	раўнава́ць зьлева, зраўнава́ць зьлева
align right	раўнава́ць справа, зраўнава́ць справа
align	раўнава́ць, зраўнава́ць
allocation	выдзяле́ньне
animated	анімава́ны
animate	анімава́ць, занімава́ць
announcment	абвяшча́льны
announcment	абвяшча́ць, абвясьці́ць, абве́сьціць
antivirus	антыві́рус
applet	мініпраґра́ма
application	(карыстальніцкая) праґра́ма
area	пляцоўка, ме́сца, прастора
argument	арґумэ́нт
ascending	наўпросты
audio	а́ўдыё
authenticate	апазнава́ць, апазна́ць
authentication	апазнава́ньне
authorization	упаўнава́жаньне
authorize	упаўнава́жваць, упаўнава́жыць
backup	рэзэрвовая копія
backup	ствара́ць, ствары́ць рэзэрвовую копію
backup	рэзэрвовы
backup server	сэ́рвер рэзэрвава́ньня
balloon	падка́зьнік
bar	палі́ца
bidirectional	двухкіру́нкавы
binary exa	э́кзбі, Эі скар.
binary giga	ґі́бі, Гі скар.
binary kilo	кі́бі, Кі скар.
binary mega	мэ́бі, Мі скар.
binary peta	пэ́бі, Пі скар.
binary tera	тэ́бі, Ті скар.
binary yotta	ёбі, Ёі скар.
binary zetta	зэ́бі, Зі скар.
binding	зьвязваньне	працэсуальнае
binding	зьвязак
bitrate	бітрэ́йт
bit	біт, біт скар.
bold	тоўсты
bug	хі́ба
build	збор
build	зьбіра́ць, сабра́ць
button	кнопка
byte	байт, Б скар.
cache	кэш
callout	вы́наска
cancel	скасава́ць
caret	стрэ́шка	знак
catalogue	каталёґ
character	знак
charset	знаказбор
char	знак
checkbox	поле пту́шкі
checkmark	пту́шка
click	пстры́к
click	пстры́каць, прстры́кнуць
clipboard	кішэ́ня
close	 зачыня́ць, зачыні́ць	для файлаў ды іншага\nto close a file — зачыніць файл\nto close a window — зачыніць акно
close	закрыва́ць, закры́ць	зрабіць недаступным для іншых
codec	кодэк
column	слупок
command	зага́д
command	зага́дны
command line	зага́дны радок
complete	сканча́ць, скончыць
connect	злучыць	пры раўназначным злучэньні
connect	далучыць	пры нераўназначным злучэньні
connecting	злучэньне
connection	злучэньне
connector	злуча́льнік
console	кансоль
contents	зьмест
content	зьме́сьціва
control	элемэ́нт кірава́ньня
control	кірава́ць
controller	кантролер
copy	копія, капіява́ць, скапіява́ць
create	ствара́ць, ствары́ць
current	дзе́йны
cursor	курсор
customizable	дапасава́льны
customize	дапасава́ць
custom	дапасава́ны
cut	выма́ць, вы́няць, вы́мі заг.
data	зьве́сткі
decoder	раскадава́льнік
decode	раскадоўваць, раскадава́ць
default	станда́ртны
delete	выдаля́ць, вы́даліць
descending	адваротны
desktop	стальні́ца
device	прыла́да
dial up	тэлефонны
dial-up	тэлефонны
dialup	тэлефонны
directory	каталёґ
disc	кружэ́лка	носьбіты інфармацыі круглай формы: вініл, CD, DVD, Blue Ray
disc	дыск	іншыя носьбіты
disconnect	разлучыць	пры раўназначным злучэньні
disconnect	адлучыць	пры нераўназначным злучэньні
disk	кружэ́лка	носьбіты інфармацыі круглай формы: вініл, CD, DVD, Blue Ray
disk	дыск	іншыя носьбіты
display	дысплэ́й
dock	стыкава́ць, прыстыкава́ць
domain	дамэ́н
double click	падвойны пстры́к
double click	двойчы прстры́кнуць
downloader	пампава́льнік
download	спампава́ць
drag and drop	перацягну́ць
drag & drop	перацягну́ць
drag&drop	перацягну́ць
drawer	высоўная скрыня
drawer	каталёґ
drive	дыск 	калі маецца на ўвазе дыск
drive	кружэ́льнік	для прыладаў, дзе ўжываецца кружэлка: CD/DVD/Blueray drive
drive	дыскавод
drop-down	выпадны́	drop-down list — выпадны сьпіс\ndrop-down menu — выпадное мэню
dump	адбі́так
early-launch boot driver	дра́йвэр заладава́ньня ра́ньняга за́пуску
edit	рэдагава́ць, зрэдагава́ць	рабіць адвольныя зьмены ў дакумэнце
edit	зьмяня́ць, зьмяні́ць	рабіць шаблённыя зьмены ў віртуальным аб’екце
edition	выда́ньне
Ei	э́кзбі, Эі скар.
E	э́кза, Э скар.
emoticon	эматыкон
encoder	кадава́льнік
encode	кадава́ць, закадава́ць
encoding	кадава́ньне
error	памы́лка
exa, E	э́кза, Э скар.
exa	э́кза, Э скар.
exbi, Ei	э́кзбі, Эі скар.
exbi	э́кзбі, Эі скар.
executable	выконвальны
execute	выконваць, вы́канаць
existing	і́сны
exist	існава́ць
expired	пратэрмінава́ны
expire	канчаецца тэрмін дзеяньня
E	э́кза, Э скар.
face down	друкава́ным уні́з
favorite	упадаба́ны
favorite	упадаба́нае, упадаба́ныя мн. лік
feeder	падава́льнік (друк.)
feed	сту́жка	напрыклад, стужка RSS
feed	пада́ча	друкарскае
feed	падава́ць	друкарскае
file	файл
firewall	заслона
floating point number	лік зь нефіксава́наю коскай
float	лік зь нефіксава́наю коскай
folder	каталёґ
font family	ґарніту́ра
font	шрыфт
foreground color	колер аб’е́кта
format	фарма́т
format	фарматава́ць, адфарматава́ць
gadget	ґа́джэт
game	гульня́
gibi, Gi	ґі́бі, Ґі скар.
gibi	гі́бі, Ґі скар.
giga, G	ґі́ґа, Ґ скар.
giga	ґі́ґа, Ґ скар.
Gi	ґі́бі, Ґі скар.
glyph	ґліф
grave accent	ґра́віс
G	ґі́ґа, Ґ скар.
hang up	disconnect
hang	завіса́ць, заві́снуць
hard disk	цьвёрды дыск
hardware	абсталява́ньне
help	дапамога
help	дапамага́ць, дапамагчы́
hibernate	быць у гібэрнацыі
hibernation	гібэрна́цыя
home	пача́так
home	пачатковы
hot key	гара́чая кля́віша
hotkey	гара́чая кля́віша
hub	габ
hyperlink	спасы́лка, гі̀пэрспасы́лка	у апошні час патрэбы ў назьве «гіпэрспасылка» няма, таму паўсюдна выкарыстоўваецца «спасылка»)
icon	зна́чак	адзіночны лік: Н: зна́чак, Р: зна́чка, Д: зна́чку, В: зна́чак, Т: зна́чкам, М: зна́чку;\nмножны лік: Н: зна́чкі, Р: зна́чкаў, Д: зна́чкам, В: зна́чкі, Т: зна́чкамі, М: зна́чках.
identification	ідэнтыфіка́цыя
identifier	ідэнтыфіка́тар
identity	асабовасьць
id	id, ID
ID	id, ID
image	выя́ва
image	выяўля́ць, вы́явіць
imaging	выяўле́нчы
indentation	водступ
indent	адступа́ць, адступі́ць
information	інфарма́цыя
installation	усталява́ньне
installer	усталёўнік
installing	усталёўваньне
install	усталява́ць
internet	інтэрнэ́т
internet	се́ціва	у тэкстах нетэрміналяґічнага характару
intranet	інтранэ́т
inverse	інвэрсі́йны
inversion	інвэ́рсія
invertable	інвэртава́льны
inverted	інвэртава́ны
invert	інвэртава́ць, зынвэртава́ць
italic	курсі́ў
journal	дзёньнік
justify	вы́раўняць па баках
kbit	кілябі́т, кбіт скар.
kB	кіляба́йт, кБ скар.
key	кля́віша	клявіятурная клявіша
keyboard	клявіяту́ра
kibibit, Kibit	кібібі́т, Кібіт скар.
kibibit	кібібі́т, Кібіт скар.
kibibyte, KiB	кібіба́йт, КіБ скар.
kibibyte	кібіба́йт, КіБ скар.
kibi, Ki	кі́бі, Кі скар.
Kibit	кібібі́т, Кібіт скар.
kibi	кі́бі, Кі скар.
KiB	кібіба́йт, КіБ скар.
kilobit, kbit	кілябі́т, кбіт скар.
kilobit	кілябі́т, кбіт скар.
kilobyte, kB	кіляба́йт, кБ скар.
kilobyte	кіляба́йт, кБ скар.
kilo, K	кі́ля, к скар.
kilo	кі́ля, к скар.
Ki	кі́бі, Кі скар.
K	кі́ля, к скар.
landscape	гарызанта́льны
laptop	лэ̀пто́п
line	радок
link	спасы́лка
load	заладава́насьць
load	ладава́ць, заладава́ць
loader	ладава́льнік
locale	ляка́ль
locality	мясцовасьць
localizable	лякалізава́льны
localization	лякаліза́цыя
localized	лякалізава́ны
localize	лякалізава́ць
local	ляка́льны	тэрміналяґічнае
local	мясцовы	агульнамоўнае
logging in	уваход
logging out	вы́хад
log in	уваходзіць, увайсьці́
log off	выходзіць, вы́йсьці
log on	уваходзіць, увайсьці́
log out	выходзіць, вы́йсьці
log	хроніка
lose	прагуля́ць
manager	кіраўні́к
manage	кірава́ць
manufacturer	вытворца
margin	поле, палі мн.
mebi, Mi	мэ́бі, Мі скар.
mebi	мэ́бі, Мі скар.
mega, M	мэ́ґа, М скар.
mega	мэ́ґа, М скар.
message	паведамле́ньне
metadata	мэтазьве́сткі
Mi	мэ́бі, Мі скар.
monitor	манітор	прылада
monitor	назіральнік	праґрама
monospace	роўнашырокі
mount	прымацава́ць
mouse	мыш
move	перамяшча́ць, перамясьці́ць
mute	выключыць гук
M	мэ́ґа, М скар.
name	імя́ (адушаўлёнае)	user name — імя карыстальніка
name	на́зва (неадушаўлёнае)	computer name — назва кампутара\nfile name назва файла\ngroup name назва ґрупы
network	се́тка
network	се́ткавы
newsfeed	наві́нная сту́жка
normal	звыча́йны
notebook	но́ўтбу̀к
notification	апавяшчэньне
notify	апавяшча́ць, апавясьці́ць
offline	па-за се́цівам
offline	пазасе́ткавы 	ня злучаны зь сеткай
offline	пазасе́ціўны	ня злучаны зь сецівам
offload	выладоўваць, вы́ладаваць
ok	добра
online	у се́ціве
online	се́ткавы	злучаны зь сеткай
online	се́ціўны	злучаны зь сецівам
open	адчыня́ць, адчыні́ць	to open a file — адчыніць файл\nto open a window адчыніць акно
open	адкрыва́ць, адкры́ць	зрабіць даступным для іншых\nto open program source — адкрыць зыходны код праграмы
open	адкры́ты	open source — адкрыты зыходны код
order	пара́дак
order	парадкава́ць, спара́дкаваць
overload	пераладава́насьць
overload	пераладоўваць, пераладава́ць
pagefile	файл падмены
page	старонка, бачы́на
paging	падме́на
pair	спа́рваць, спа́рыць
panel	панэ́ль
paper jam	заціска́ньне папе́ры
parameter	пара́мэтар
partition	разьдзе́л
partition	дзялі́ць, падзялі́ць
partitioning	падзе́л
paste	устаўля́ць, уста́віць
pebi, Pi	пэ́бі, Пі скар.
pebi	пэ́бі, Пі скар.
perfomance	прадукцы́йнаць
personalization	пэрсаналіза́цыя
personalize	пэрсаналізава́ць
personal	пэрсана́льны
peta, P	пэ́та, П скар.
peta	пэ́та, П скар.
picture	відары́с
pixel	пі́ксэль
Pi	пэ́бі, Пі скар.
placeholder	запаўняльнік
player	прайграва́льнік	узнаўляльнік відэа-, аўдыё- ды іншых файлаў
player	гуле́ц	адносіцца да гульняў
play	прайграва́ць, прайгра́ць	узнаўляць відэа-, аўдыё- ды іншыя файлы
play	гуля́ць, згуля́ць	адносіцца да гульняў
plug-in	убудова
plugin	убудова
pointer	указа́льнік
pop-up	выплыўны	pop-up window — выплыўное акно
popup	выплыўны	popup window — выплыўное акно
port	порт, парты́ мн. лік
port	партава́ць, спартава́ць	адаптаваць праґраму да іншае плятформы
portable	пераносны	пераноснае апраграмаваньне, якое не патрабуе ўсталяваньня
portable	партава́льны	адаптаваньне апраграмаваньня да іншае плятформы
portage	партава́ньне
porting	партава́ньне
portrait	вэртыка́льны
preferences	нала́ды
press	ці́снуць, наці́снуць
print area	плошча дру́ку, поле дру́ку
printer	друка́рка
print	друкава́ць, надрукава́ць
proportional	суме́рны
protocol	пратакол
provider	права́йдэр
publisher	выдаве́ц
publish	выдава́ць, вы́даць
P	пэ́та, П скар.
rate	1. noun часьціня́\n2. verb ацэ́ньваць, ацані́ць
reader	чыта́льнік
recovery	аднаўле́ньне
recover	аднаўля́ць, аднаві́ць
recycle bin	сьме́тніца
redo	узнаўля́ць, узнаві́ць
refresh	абнаўля́ць, абнаві́ць
register	рэґістрава́ць, зарэґістрава́ць; рэґістрава́цца, зарэґістрава́цца
registration	рэґістра́цыя
registry	рэе́стар
release	вы́пуск
reload	перазаладоўваць, перазаладава́ць
reminder	нага́двальнік
remote	адле́глы
remove	выдаля́ць, вы́даліць	для выдаленьня
remove	прыбіра́ць, прыбра́ць	для выманьня элемэнту са сьпісу
rename	пераназыва́ць, пераназва́ць
repartitioning	перадзе́л
repartition	дзялі́ць наноў, падзялі́ць наноў
report	справазда́ча
report	паведамля́ць, паве́даміць
repository	сховішча
resolution	разрознасьць
restore	аднаўля́ць, аднаві́ць
revision	рэда́кцыя
roaming	блука́ньне
RSS feed	RSS-сту́жка
RSS-feed	RSS-сту́жка
sample	узор
sample	узорны
save	захоўваць, захава́ць
scan	сканава́ць, сасканава́ць	апэрацыя сканэра
scan	прагляда́ць, праглядзе́ць, прагле́дзець	пошук у чымсьці
scanner	сканэр
screen	экран
sensor	сэнсар
sensor	сэнсарны
server	сэ́рвэр
settings	нала́ды
sheet	а́ркуш
shortcut	скарот
sign in	уваходзіць, увайсьці́
sign off	выходзіць, вы́йсьці
sign out	выходзіць, вы́йсьці
sign up	рэґістрава́ць, зарэґістрава́ць; рэґістрава́цца, зарэґістрава́цца
site	сайт
size	паме́р
software	апраґрамава́ньне
software	праґра́мны
sound card	гу́кавая ка́рта
statement	вы́раз
storage	сховішча
storage	захоўваньне
storage	захава́льны
store	захоўваць, захава́ць
strikethrough	закрэ́сьліць
string	радок	калі «string» мае сэнс «line»
string	чарада́	фактычна — тып зьменнай
style	стыль
subscript	падрадкоўе, падрадковы тэкст
subscript	падрадковы
summary	падсумава́ньне
superscript	надрадкоўе, надрадковы тэкст
superscript	надрадковы
swapfile	файл падме́ны
swaping	падме́на
symbol	сы́мбаль
synchronization	сынхраніза́цыя
synchronize	сынхранізава́ць, ссынхранізава́ць
synchronizing	сынхранізава́ньне
sync	сынхраніза́цыя; сынхранізава́ць, ссынхранізава́ць
table of contents	зьме́ст
tablet	тэ́блет
tebi, Ti	тэ́бі, Ті скар.
tebi	тэ́бі, Ті скар.
tera, T	тэ́ра, Т скар.
tera	тэ́ра, Т скар.
terminal	тэрміна́л
tile	кафля
tile	кафлява́ць, закафлява́ць
Ti	тэ́бі, Ті скар.
trackball	трэкбол
trash can	сьме́тніца
trash	сьме́цьце
typeface	ґарніту́ра
T	тэ́ра, Т скар.
underline	падкрэ́сьліць
undo	адрабля́ць, адрабі́ць
uninstallation	высталява́ньне
uninstaller	высталёўнік
uninstalling	высталёўваньне
unistall	высталёўваць, вы́сталяваць
unmount	адмацава́ць
update	абнаўле́ньне
update	абнаўля́ць, абнаві́ць
upgrade	мадэрніза́цыя
upgrade	мадэрнізава́ць
upload	запампава́ць
URL	URL
URL	а́драс	размоўнае
user	карыста́льнік
user	карыста́льніцкі
value	значэ́ньне
variable	зьме́нная
version	вэ́рсія
video card	ві̀дэака́рта
viewer	прагляда́льнік
view	прагляда́ць, прагле́дзець, праглядзе́ць
warning	папярэ́джаньне
warning	увага	агульнамоўнае
web	се́ціва
web	се́ціўны
wheel	колца
window	акно
win	выгу́льваць, вы́гуляць
wireless	бяздротавы
wire	дротавы
wizard	памочнік, ма́йстар
Yi	ёбі, Ёі скар.
yobi, Yi	ёбі, Ёі скар.
yobi	ёбі, Ёі скар.
yotta, Y	ёта, Ё скар.
yotta	ёта, Ё скар.
Y	ёта, Ё скар.
zebi, Zi	зэ́бі, Зі скар.
zebi	зэ́бі, Зі скар.
zetta, Z	зэ́та, З скар.
zetta	зэ́та, З скар.
Zi	зэ́бі, Зі скар.
zoom	1. noun суме́р
Z	зэ́та, З скар.
@	сьліма́к
